~~~~~~~~~~
~~...k..~~
~...T....~
~.T..v.p.~
~....R...~
~..R..k..~
~~......~~
~~~~~~~~~~