~~~~~~~~~~
~~......~~
~...T....~
~.T......~
~....R...~
~..R.....~
~~......~~
~~~~~~~~~~