~~~~~~~~~~
~~...k..~~
~...T....~
~.T..v...~
~....R...~
~..R..k..~
~~......~~
~~~~~~~~~~